G       ~~~#
####   ~~~~#
~   S    ~~#
## # #####~#
#  #      ~#
# ##### ####
#       ~~~#
## ### #####