G       ~~~#
####~~~~~~~#
~   S    ~~#
## # #####~#
#  #      ~#
# ##### ####
#       ~~~#
## ### #####